1111111111111111111111111111111111111111111111111111111111111111111111111111111
1P00000000000000000000000000000000000000000000000000000000000000000000000000001
10CCCCC00000000000000000000000000000CCCCC0000000000000000000000000000000CCCCC01
10CCCCC00000000000000000000000000000CCCCC0000000000000000000000000000000CCCCC01
10CCCCC00000000000000000000000000000CCCCC0000000000000000000000000000000CCCCC01
10CCCCC00000000000000000000000000000CCCCC0000000000000000000000000000000CCCCC01
10CCCCC00000000000000000000000000000CCCCC0000000000000000000000000000000CCCCC01
1000000000000000000000000000000000000000000000000000000000000000000000000000001
10000000000000000000000000000000000000000000000000000000000000000000000000000E1
1111111111111111111111111111111111111111111111111111111111111111111111111111111