1111111111111111
1E00000A00000AC1
1010010100100001
1010010010101011
1P000A000CA0C001
1111111111111111