1111111111111
100100C00A0C1
10C0011111001
1P0011E000001
11111111A1111
1111111111111
